28
19
############################
#  #        #              #
#  #  ##########  #  #######
#     #  #     #  #        #
#  ####  #  #######  #  ####
#  #     #        #  #     #
#  #  #######  #  #  ####  #
#        #     #  #  #     #
#  ####  #######  #######  #
#  #     #              #  #
####  #  ####  #######  #  #
#     #  #     #           #
#  ##########  #  ####  ####
#              #     #  #  #
#  #######  #  #######  #  #
#        #  #     #        #
#  #  ####  #  ####  #######
#  #  #     #  #           #
############################
