28
30
############################
#  # $      #             $#
#  #        #              #
#  #  ##########  #  #######
#     #  #     #  #        #
#     #  #     #  #       $#
#  ####  #  #######  #  ####
#  #     #        #  #     #
#  #     #        #  #     #
#  #     #     #  #  #     #
#  #    $#     #  #  #$    #
#  #  #######  #  #  ####  #
#        #     #  #  #     #
#        #     #  #  #     #
#  ####  #######  #######  #
#  #     #              #  #
#  #     #              #  #
####  #  ####  #######  #  #
#     #  #     #           #
#    $#  #     #           #
#  ##########  #  ####  ####
#                    #  #$ #
#                    #  #  #
#  #######  #  #######  #  #
#       $#  #     #        #
#        #  #     #        #
#  #  ####  #  ####  #######
#  #  #$    #  #           #
#  #  #     #  #     $     #
############################

