28
10
############################
#  # $                    $#
#  #                       #
#  ########  #########  ####
#                          #
#                          #
#  ########  #########  ####
#                   #      #
#                   #      #
############################
