28
30
############################
#  # $                    $#
#  #                       #
#  #  ##########  #  #######
#     #  #     #  #        #
#     #  #     #  #       $#
#  ####  #  #######  #  ####
#  #     #        #  #     #
#  #     #        #  #     #
#  #     #     #     #     #
#  #    $#     #     #$    #
#  #  #######  #  #  ####  #
#        #     #  #  #     #
#        #     #  #  #     #
#  ####  #######  #######  #
#  #     #              #  #
#  #     #              #  #
#  #  #  ####  #######  #  #
#     #  #     #           #
#    $#  #     #           #
#  ##########  #  ####  #  #
#                    #  #$ #
#                    #  #  #
#  #######  #  #######  #  #
#       $#  #     #        #
#        #  #     #        #
#  #  ####  #  ####  #######
#  #   $    #              #
#  #        #        $     #
############################


