28
9
############################
#  # $                    $#
#  #                       #
#  #  ##########  #  #######
#     #  #     #  #        #
#     #  #     #  #       $#
############################
